6 6 3 6 6 6 6 3 6 6 6 6 6 6 6 6
6 6 6 6 3 6 6 6 3 6 6 6 6 3 6 6
6 3 6 6 6 6 6 6 6 6 6 3 6 6 6 6
4 5 4 4 5 4 4 4 4 4 4 4 5 4 4 4
0 0 0 0 0 0 1 0 0 0 0 0 0 2 0 0
0 0 1 0 0 0 0 0 0 0 0 1 0 0 0 0
0 0 0 0 0 2 0 0 1 0 0 2 0 0 0 0
0 2 2 0 0 0 1 0 0 2 0 0 0 0 0 0
4 5 4 4 5 4 4 4 4 4 4 4 5 4 4 4